..###############
#...............#
#...............#
#....#######....#
#....#.....#....#
#....#.....#....#
#....#.....#....#
#....#.....#....#
#....#..........#
#....#..####....#
#....#.....#....#
#....#.....#....#
#....#.....######
#....#..........#
###############..