..E...#.....#.....#.
###.#####.#######.#.
....#.#.#.#.......#.
.##.#.#.#.###.###.#.
....#...#.#...#...#.
###.###.#.#######.#.
....#...........#...
###.###########.###.
..#...#.#...#...#...
..###.#.###.###.#.#.
..............#.#.#.
###.#.#######.#.###.
....#...#.......#.#.
.######.###.###.#.#.
..#.....#...#......S
..#.###.#####.###.#.
....#...#...#.#...#.
#####.#.###.#####.#.
......#.#.........#.
####################
