#SS#####################################################################
#.........................#...........#................................#
#.........................#...........#................................#
#.........................#....#......#...#............................#
############...#..........#....#......#...#............................#
#..............#...............#..........#............................#
#..............#...............#..........#............................#
#..............#....###############################################....#
#..............#..........................#............................#
#..............#..........................#............................#
#..............#..........................#............................#
#..............#..........................#...........#................#
#..............################...#.......#...........#................#
################..................#.......#...........#................#
#...........#.........#############.......#...........#................#
#...........#......#..............#.......#...........#................#
#...........#......#..............#.......#...........#................#
#...........#......#..............#...................#................#
#######.....#......##########.....#...................#................#
#...........#......#........#.....#...................#................#
#......######......#........#.....##############.#######################
#..........#.......#........#...............#........#.................#
#..........#..######........#...............#........#.................#
#....#.....#.......#........#...............#........#.................#
#....#.....#########........#...............#....#####.................#
#....#.............#..#.....................#........#........##########
#....#######.......####......######################..#.................#
#....#.....#..........#......#..............#........#.................#
#....#.....#..........#......#..............#........########..........#
#....#.....#####......########..............#..........................#
#...............#......................................................#
###############EE#######################################################