a..##############
................#
#...............#
#......#####....#
#..........#....#
#..........#....#
#....#.....#....#
#....#.....#....#
#....#..........#
#....#..####....#
#....#.....#....#
#....#.....#....#
#....#.....######
#....#..........#
###############.b